100
0100000000000000000000000000100001000000000001000000000010100100000000000010011111011111011011101111
0000100000000000100000000000000000000000000101100000000000000000000010101111011111111100101101011011
0000000000010000000000100000000100010000000000001001000000101001000100001111010110000110101101100101
0001000000000000000000000100000000000000000000000010000000000000000001000110000101000111101001101110
0000000000000000000010100000000010000000000000000001000000000000000000000100010010011010100010100111
0010000010000000010011000000000000000000000000000000000100111000011001000000001100100101011000100111
0000010000001100000000000001000000001010001000110000000000000000000100000000101111101110100100101101
0000001000100000000001000000000000001001000000110001110100100000010000000000010100010000110011101000
0000000000000000000100010000000010000100100000000001100010000001001000000000110110110111011111001001
0000000000000000100000000110000000000000001000000000000001000000000100000000001101001111100111010100
0000010000000000000000000001000000000101000000100000010000000000000000000011101010000111101110001001
0000000000001100000001010000000010000000000011110001000000001100001000000001011011101101100101110011
0000000000001000010000010000000000000011000000100000000010000000000000000000000100110100000101101100
0000000000001000000000000000001000010100001000000110000000000000000000000000000011100100000010010000
0100011001101000000000000000011100000000000010000000100000000000000000011000000110010000110010110010
0000000000010000000100100000101000010010000000000000000000000001010010010000010000100111000000010101
0100000000010000000000000000000000000000000000000000010100000000000000000000011110011000101011001101
0000000000000001000000000000100000000000101000000000000000000000000000000000000011000001101101100111
0000000000010000000000000001010000000000001101000100000000000000000000101001101100110000110011011000
0000010000000100000000100000010000000100001000000000000010000001000010000000000001101011110100011011
1100100000000000000000000100010000100000000000001000000000000000000010000110000101001110100110110011
0100000000000000000000100000010000000001000100110000001000000100000001000000000101111010100110001101
1001000000000000000000000000001000000000000000000100000010001000000001000000000001001110010000010101
0000001100100000001100000011000010000000000100000000010000000000001001000000000011111001111011110001
0000000000000110000000000000100000000100000000010001000000001000000000000000000000010110101001110101
0010000001001001000100000001000000100000000001000100000000100000000000000000000011010010110001110101
1100001000000100011000000000000100000000000001010000001000010000001000010100001011010001101011111110
0100000001001000001010000000000000000001100000010010100000000000000101000000001100100001110011110110
0001000010000000010000001000000000000010000001000000000011000000011000000011101101001101100110100100
1001000110000000001101000100000000000000001100100000000001111001100000001001111100101101101110011111
0100000000000010010000000000000000100001000000100000000000000000000000000000001101110110101010001010
0110000000000000000000000000000000000001000110000000010000000000100000000000010000010000000100100100
0000000001001100100001000000000101000000001000000110000000000000000001001000000100010101101011101000
0000000000100100000000010000000001000100000100010000000000000001100100000001000111001011001101100001
0000000001000000000010000000000000000100000000000000000000000000000000110000000100011111001011001011
1000000001110011010000100000000100000000100010001010000000000000000101000000011011001000010110111100
0000000000010000000000000000000000000101100111000010010000000000000000000100101100010101010101110110
1000001011000001000000000100000000000010000100000000000000000000000000010000000110101000000110000111
0000000000100000001000000010000000000000000001000000100000000000000001000010000000110001110101100001
0000000000000100000001000000001001001000000000000010000000000000000000010000000110101010110100100010
0000000000100100000000100000100000001100000000010010010000000000000000001000001110110101010000001011
0000001000000100101000000000000010000000010000100000000000010000000000100000011110001111001101010101
0000010000000000001000010000000000000000000000011000000010000000000100101001011010110011000010100000
1000000000000000101001010000000000101000010000000010000000000000000001000001011011100101111100110100
0000000000100000000000000000101000000000000100000000000001000000000000010100011010010001001100110011
0000000001000000000000000000000000010000000000010000100000000000100000000000000001101001111100111110
0000010000000000001000000000010000110000000000001000000000001001010000000000101110000011110101101010
0000100010000100000100100100000000010000000001100000000000010001011010010000001100001100001100111011
0000000000001010000000000000000000000100000000001001000010000001000000001010110000011111111011010111
0000000000000000100000000000010000010000000000000100000000000001001000000010000000000101011011001110
1001000000010010000000000000000010001000000000000000000010001101000000000001100011110100110001010010
0000000000100000000100000001000000000000010000000000100100000000000001011001110001011000111110101110
0000000000000000000100000000000000000000011000000010001010010000000110000110100010110101110011101010
0100000000000000000010010000000000000000000010000000000001000100010000000011100010010010010101010000
0010000000011000000000000000010110010000010000000000010000111011000000000010001110101101011010010111
0000100000010000000000010000010000000101000010000010000000001100000000000001101111011000100001000100
0000000010000000000000100000000001110010001000000010000000000000010000000011111011001101111011111100
0000000000001000000011000010001101000000000000000000000000100000000010000011010100011000000100111100
0110000000000000000000000000100001000000000000100100010001110001000000000001100100110100110000001101
0101000000000000000010000000000000000000000000000010001000001000000000100000001010100011000100011001
0000000000000000000001000010000000000010000101000100000100000000000000000000011010111100011111011000
0100000000000110101000010000000001000010110000001000000001000000001010000110001011000010011000010001
0000010000000000010010010001001000000000100000000000000100000000000000000100101110011000101100000101
0000000000000001011000000000000100010100000000100001100000001000000000000011000000110011100000010010
1000001000000000000010010010000010000000000101000000001000100000000000000110111110101101100111110000
0000000001000000000010110000000000000000011101010010000000000010000000001111011101111000011100101011
1100000000000000001000000000101010110000110010001000000000000000000000010111101110101111010000110001
0100010000000000000010000000000011001000010001000000000010000000000011110000111110000110010000100010
1101110000000000000000101000000010101001000101001000000000000000000011011000101001000011111110010000
0000011011100011001000001100000000000100000000000000000000000000110001110111111000110101000010110110
0011000000000010000010001000000000000100010000000001000000000011100101011011110101110011010010100000
1000000100000101000010000000100000010000000011001000000000000001110010001101001010001110111101000001
1010011000100000000000000000001000000000000010101100000000000111010010001101001111000000010100010011
1100000000000000000001000100000001000011100000100000001010000011011001110010001000100100010101101011
0011000000000001000010001100000000010000000000000001001100111100100010101100011101111111010000011010
1100001000000000000010001010000000000000000001000001000001000010110011010000000000110000101011111001
1001010100000000000100000000001000000000000001110100110001011101010111011110111000011000111110101010
0011111110000000000000000000011000000001111101101000010100001110001001101101100101111110101101101001
1010010101000000000000000000101100000000011100100100010010011010001011010111000111110101001000110001
0001010100111011110010111111100101010111000001110101000101001010001110000101110010010110010011110001
1100100000100001000101011111110111011110110000001011111000101101011000000011001011111011010000010001
0111001010101011100000100011110101110100101000010110000001101011011000011011001111011110110011000011
0101001000110101110101111101111001100110001010100100000010110100101001110101101010011101010100001011
0111011001100001111110111111010001111100101110011001100101000001000110011100000111000010100110100100
1110010101001011011001101110001110010101010000011000101111010101011110001100111001111110001001100111
1110011101111001110111000110111101100001111000010010101111000101000100101001011100000010010101101001
0100101111100001000011111010000100000000111100111000101011110000000101101100110011001000000011010001
1111000011100100011100010011010011000100100010010000101011001100101101000000000100111011010000000000
1111100111101111100101101101001010110010110110111000010101001001101100000010111100010001110001110111
0010101111010010101101100111111101100001111101010110010111100000111100111111010010000101100001111111
1110001000000110100100011100010100001010001100011111111110111001101001110110100101101111100100101011
0010001000101010111000110010001011010111011000100101110001101011010001010001111001101010011111000100
0111000011000110010000000000001110100001100100001001111001111111001110001010100001100000000001001001
1011101001101000000101010010101000111010101000001011100000011100111011011110100111101110001000110001
0111010011111011011101110100011110111010000111011111100001101001111111110010001010010011010100010101
1010100011000010001110011100111110100001011111000110111110001101000110000011011111101110101000000000
1100011001010100011000000111011111111011101110101100000111010000100010100111101111001101010000111100
1011100100100100010110010001100111010100011101110000111010000100010101100100111100111010111110001010
1110010010010100011001001101111001111100001100100000101101011101100100010001100011101011010001101000
0110101000110110110101100011000000111101101101111111111110111100011100001000010010000110000010011010
