100
0001001110000111111010110000100000010000000010001001001001010101010000010100110110000000000011010110
1000000000000000000000011011110111100101111000000010101000001000010110011001110100001110111000000011
0001101001101111101110000000000000000111010111101000001011101011110101100011111010011001000001001000
1100000100001010011100010100000111001001101101111010100000000000111000111010111000110000000000101011
0101000100100111111101110101110100100100101011101011101111000000000000101001000000110001010000110010
1000101100111100100111101100100000100000100101011010000011101111101000000000001010101000000000011011
1001001001101011010001110000010100110010000100000011111110110001111101001111001011000000000101001001
0001110110001110111111110101101000010111111000111110100101111111111111100010111000100101000001010100
0101110100100110000000001001111110001110000000010101000000010000100000111100011100010101010001000111
1101010101011110100110010000110110110111100011100100011001001111110001101000001100111001111010011001
0100101110010010111001011101110010000011111001001111001011100110100100010100000110000000000000001101
0000111111100000100111010010011001001000011000011111000101011110100000100100111000011111001100110111
1000111010010001100001101010101100100000011010100000111011110000000000000000000011110001010100010101
0000011110110111110100111001010100110001001100101010010100110000000100000000011001100000000010101001
1000010111111011100000010110100111101000000000000001101001110100010100010100110100100101010000010010
0110100001011100010111000000000000111111010110101011000010100000010110001000000010000010001000010010
0000011000100000011011000000101101101001111101110010101001010101010000000000000000010011010001010111
0110111010100101000010111010000000010000111000011001011000011000100101000010101000001101010101001011
0110011010000111101101011001110000000000010000011000001100000000101001000000000000010100010001011101
1010111111110010100111101000100001101000000100101000011000100110001000000011100000100101111011011100
1110111111111001111101110010000000000101011000000101110110000001001100010010000000100001000000011110
1010100101110111000000110001001001101100100010000100011011000001100010000000101010110101101000001110
0100000001110100000011010100000100010110000100010101001001100111111001001110100100000111110011110010
1010110111111111101101011010000001000111101110000110000000011101100101110010101000100011101010011110
1000110111000100010011111010011100110000000100000010011011000000000000000010111110100111001001001100
0000010000010110101100111110000000001101100100100001100000000011101010111000000000000001111000011011
0000001001000011001010011011110000010100001000000001010000101101110111010100110001100110001000111000
0010010011011000011111101100101000100001011010101000101100001010110011100101101010000011101111000011
0010100000110010000110000011001101001110110001000000011111000111010000000101000000011111111101011011
0011111010100000000001100001111010101000101010001100001011011010001010010100101010010100001000100000
1001100001111100100000010000001010000101000000001101100111010100010000010001000000101101001100100110
1001100011001001111010011011011001100001001011100011011110001000000010001101001010100010011000011101
1010011000011100011100000000000000111100100001010000000000101110010110000000000011101111011100000000
0000101000101000001100011010000010011100110010001000100000100001110110101100100100111111001000100111
0101101110101000100101011001111110001110011100010001011110101100100100010000011111011101010000001000
1000101100010100100110001110000010100111011001010111001010111010001000001000000110110101101011100001
0010101100110011101111110010000101010000010000000000000010010001000110000100111010001011110001010011
0010000110110010110001000111111000111000011010100111001001001010100000000010011011110010001111010111
0001001110111100000100000100010101000101001000010100000001001000010111010001110010011010100001001111
1010111000101100010010110110000000000111000100010000000000101010100010001101011100101010100100001011
1100001110110100110011010010001101011010110011000101011011001011010101011101000000101100001010000001
1111110100010111011100011000000001110000100000100000000000000010000000001100011110011101101101010101
1111101010010000100111011000001000000100010001000011000011110001010101100101001000000001101101000010
0111011101011011001110100110000011100110011000111101000000001010000000111111101111111110011010100010
0011100111001000011010100010001011100101001000000101010001000000010110110110001010110011010010001011
0011001000010001011010101001101000010100100011110110001000101010101111111110000001110010001110001110
0001101111010010111110000001010000010100011111010010000001000000001101111001000100001101001110100100
0111100010000001100001000100100010010000000000010110001000001001110110100001110001100001111000100010
1110111011001100000000111111000100000100010001010111100100001010100101010110000010001110100101111010
0110101000000101000010001110101110001000000010010000110001101110111101001000010101010011110100001100
1011000111000111111111000000010001000101010000100010000000000110110011001010001010000100010001101011
0000110000011111101101010100001000000000000000010111001110100001100111110100110101101000011010010010
0100000001011010000101011111100101001010010111000101010000011011000010010000101100110100100101101011
1110100110000100101111101111010011001011000000101001010000101011011011101000100111001111010000011011
0010011001100111000011011001001011100100110100101000000000110010010010011000001111101100101010101001
0101111101000110100110101100011001010000101010101010101001001000101001010100111101111001100110011110
0000100100101100110010111000101000111010110000001000000100011010101011101101100101100000010011110010
0000001111001010110000110100010101111100100000101010100111110111111111101001001001011001010010110000
1000000110001100110001000001100100000101000101000000000010110011101010100001111001000001101100101000
0001000111000110110110000100000111011110000010001011110001100000011100110101110101001110000101101110
0101100001001010000010101101001000001000001101000000011001110011100110100000001011001011000011011111
0100000001000000001100000001110000100110101000101001000000100011011010010000010010111011100010011111
0100110011000100000110010000000011010011001101000011101100010001001110111111010110001110001101111111
1101110010001001000101001001001110011000000000000011110110001111010101101001000101110100010100110111
0100001010000110000001000010101000000100011010000000001101000001001001000000100000000010110001011110
1100100101011110100000101000101000010001100000001011101001100011100001001101010001100110000010110000
1001000100001000101010100000101010001101000001111010101110101011010100001000001001100100010111110101
1001010100101010011100010001000000000101000000101011111101100100111100001000000100000111111001110100
0010100110000011100111001011010110000000000010001110111000110001100101111010011111100001111110001001
1000100110010100101100100100000000000001000100001111111011111010110101111011010100001000101111100101
0000101000000010001110100010000010000100001100110000001010101111010000100101110000001011100111101001
0000101101100100100100011010010100010000110000100110011111111110010000010010001111101011110010000001
0010100001010000011010101001101011000000010010100011111100101101010010110011000001001110010111111010
1000011101001001100000001000000000000000000110111101001110000101110111100001101010000101111011111000
0000000100111011000001100101001111101011101011011111000101111011001000110111010000011110010101010010
0001010110001001101100010001001100000000010110101111100010011101111001110011001111001101111111000101
1000000010110100101000001100100100001111011001101100011110111000000010010110010000001001100100100010
0010110010101001111100011101010000000101010001101011011010001101101111001011011111001010110101000001
1010001100011000001000000001000000101111010000010101100110001110010110011100001110101100010011101101
0100100010011101100101011001000001000000101001101001111110100100011001010000100010001001101011100001
0001010010000000101010001101000011110111010010111111111100010000110000110000100101001111011101001101
0000011000000000110000010101000010101011011010111100100101001010000001000110010101000000101001011100
0000001100111100010000000000001001110110001101011010011001000100010010101101101101101100110111011000
1000000110001011010000000001000101111111111100110000101010010100000111101000000111101110101001001101
1110000010101010011010001000110011100101000111100101011111110011001001001001100111101010111111000100
1101101110010001000001010100000000111010001001110010111001011100011010010010111100101010110100010001
1000100100100010001100001100001010001111101101001011110001100100100101011100011010011000100001010000
0000000001000000010001010011001111111101011101111100110000110011011001110100101000101010001110110101
1010011101001011001000000000110011000111001111010011011011110011001110111001000111101110011011011100
0000000101000001010101101011010111100011011100011110111010011110011011111111101101101101000100100100
0110001101000010000000100101010101110100000010100110001000000011100000110111111000110001101001100001
0010010100000100000001100011100110000000110110001110001110101110011111100011101110100001001101010101
1001000001001000000011000111111100011101001100001001100100001010100111011010011000100111101001001100
1101000001011000011100101100011101000011111101110011101100110000011111011011001111110110110010001010
1100110000101110101001110000110010000101110010001110111001101010100111100011011000110001111100011000
1100011101100110100000001011011110010010100111101011111110010000100111101101010111010100001111010110
0101101011111100000011110011111000010010000111000011110101101011010000001111010101100100000110110000
1101111101011111101110100000101011001010010110011100100100001011000110111011110010100111111000110001
1010100111111000110101001101100000110110000110011110010100110011110000010010010010000000010111011011
1010010011101011011110011001001010001100101110010101100011001110011111000000101011101111110000110000
