100
0001000010000110001100010001000000010000011011000001100000001000011100000111100000100100011010001000
1101010010100000101001010100011111010110010001011100100011010011011001110001001010001110111010001010
0001010110110111001010010011110000010001000101000010001100010110001010001101011101101010001000101010
0010010000101001010010100001100111101100100101011001110000010100110010000001000110001000001000101010
0110001001000111010100010001001000110010011100100010000111100010010110111111110100010011101011100010
0001100110010001010101111001000010000010100010101110110100011001000100100011100100100010001001011110
1100110100101000010100001001011101000010001010100010001001011000101001001000001101101101010011100010
0110010101000111100111000100100000101001110010011010101010010100111011010111111001100011001010101000
0001000100010100001000110010101110110010000111000011001010100010010000011000010010110001010010100101
0101111011100100110000111010100010000010111000111100010010101001001010100011010100111101000100010010
0100100011100100110100011000011011110100001100100001100100100101001111000100010100111001111001001000
0010001001001101110010000101100010001000101000101101001001100100100110101001110000110010000000101110
1001111100010100001011010011001100100111001010100011010010000010010011001010101100010111100001001100
1100100011100010010011100100010101110001001010011010010101101001000110001001000010100110101010010110
0001001011001001010100001001111000011100100001010010110000010100111000011100101010101000001110111000
1101001000011101000101011010000111010110011110010100011110001110011010100010001000100011111000100000
1001010111110000111100111011010010010001001000010001100001001011011011001001111001111100111001000111
0010011000010000101010001010001010110100101001101110001100101100010010010100000110000101010011110001
0010010011010111100010101000110010110110001010000110110001000001100100100011110010110011000010001100
0100100111010001101011001111110100110001010010100010010111101110101101101000000100001001010100101110
0001001101011100101010010000010001101100100010011001010100010000101101001101111011001001010100100010
0010010001000110001000100100001111100010001101001000010101010110100100100010001010000101001001010100
1010100100110011110101001111001000101001110001100111110001010010010110100100100100101001100010110101
1110001001100111000111010001000010100100110100001100001110001011000110110001010010010010111110000100
0001110010001000010011000101111100010010110011010001010001100001111100101110001001010101000100111010
0100100100110001101010101001000010100110001001100110010100011110000101101110100010010001010100100000
0010001000100011000010010010010010101100101000001000100010100000101101000110111110011100010001001001
0111111011001100000100010010101000100011001111110011001100100111001001010100101100100111101010011110
0000001000011000111001010010111111011011010010001001000101110011011010010101000100011100000100101000
0110000111111011100011000110100001110011001000101000100100100001001010100100010111010001110110000010
1101001100010000101100111000000100100010100011001110010110011100100010110011100111001001010101111110
0001010001010110100010000111001010101100010100010001010001001100111100001000001000100010000100011000
0101000110011000010010110001010000100001011100100100011001100010100011101111110010101100001001010011
0100111100100001101010001100100011111010010001101111011000101000101001101000010100011001110011011000
0010010001001110001011100110110110000100100111101000111110011111000101001011010011001010001001001110
0001010110011000101000010100100001010001001000100010100001001000101100010010010000101000100100100010
1101000101000101001010000110111001001111010010011100101100100010100011100100101101001011001010010010
0100111000101101011100111010000100010001000010001001001001111100011001100110010001011110010001001000
0001100010101001001111110001110100110100111111000010010010001101110010101110000110000100100100100111
0011001100100011100000100101000111000110010000111100111010100100010110001101111110110101001110101000
0101001101111100010110010100001000001010010010001000100010010011010100010000100001000100011100101010
0100011100001001011101010111110011110000100101101011001110111000010100100110101000010111110101100010
0001111011101011010001000100010000010011001001101001010110011111110000101100100111111000001101111100
1111000000101001000100111001001110110110010110000101000001000000110111001001010010100011010001100010
0000010101101011110100011100100000010010000100111001011100111100001101011011001001001100001001001010
0111111001001010001011001110011011101011110010001010100001000111010001001001010010001101110001011000
0000010010010010100011010001000100001001100111001001010111010111010100100100100100011100010110011111
1111001000100100110010010100110001101100001000100100010010010010010010010110001000111111010010100000
0001100111000100100010100100100110001011110010110111011000101000100101010111111011000001001010001110
0100110010011001111000010010111000010001000010100100011111001111100100010000001010010100100001110000
0110100100100001010111101010001001100101011100000100110001000110000101111101101000111001111110000110
0100001001000111100010000011101010001001000011111101000100010110111100000111000111010010000010111101
0011111010001000101011011100001010110011111000101100011011110100100011010010011000010100110010001000
1001101001010010001001001101110010010100010110000111111000100101001000100100100010110010001001100010
0101000101010100111000100100100111010101000011101000001010010101010100101101101110010011000100011100
0001010101010111000110110010101000010100111010001001101011000100011100100000100101010101110011001101
0110010101000100010100100100001011100110001010110010001000111111110110111001101000010000010111100100
0100110101001001100101001011110000101111101000110110110110001010001100000110001011110110100011001110
0001110001110100100100011000011110100110000101000110000011100110100010110100111000111100010010010000
1110001110001010100010100011010000110010111111011011110100010110010010100101000100010001101010100111
0000100010100000111001000100010101011000010001000010000101000111010001001001010011000110000010001000
0011110110011001000100101110110010000111110101110100111000111000011100100011001001111100110111010010
0100010010011111010010100010011000100100100100000101000110110000001010011100010011000010001000110110
0101001001010001001010010001000111001011000111111101010100100111110001001001010101101001100010010010
0101100101010100010001001100110101010001001110001100010000100100010100101010100010100100011111001010
0001010100010101101001100001000100010101000010100011101111001001010010001000010000010010011000100010
1110000111110110000100101111010101110100110010010100001001010010011001110111001101011001001010011110
0000011000010100010010010001001001010100011000100101000011000100010100010000101011000100100011001000
0011110010100100101001010100100010000111000111001101111001111001100111010101001010110010011110011010
1000010110101001000100010010011100111000101000010001000101000100011000010100010000101010000100100010
1111000110001010010011101001001001000010101000100001010100010011011010010011100110010011110101001101
0000110101101000010111011101100011110110001001001110010010111000010001011000010100101001010101010100
0010001000011101110000100001111100010001111010001000111001000111111001100111000010000100110101001000
0111101010001110001010101011100001000110001000110011100010010010000101100001111111100101000101000010
0010001001100100100100101100010100111100101011000100001100001010010100101100000100001001000101111100
1010110100010001101001001101010011110000101100011001110001010010100100100111000110010011011100010100
0010001011011110101010011001001000010011000101101010001010101000101010010000110000100101000100101010
1001100100010000001000010010100110100110110100001000101000000111100001001010011111000100100010000010
0000101001100111110111101000010000101000000101100111101111000100010010010100100001010100011001110010
1110100100010110000010000111010011001011111111010011001011101001001000110001001101001001010010001000
0000110111010010101010110100011100010000010001010001010000100010100111000110000100101001010100101111
0111010000011010010000100100100001111111010101111101010100111110001010011000110110100101000101001000
0100001101100010001011001001001010000100010100011001000110100010110001001010111000100001111001010010
0101000010001111001110010011011100010101110011000011111000101010010100101001101001111111010011001010
0101110001011000101110110111000101100100101011111100010011001001010110100010001010000100010100100010
0001010101001010001110000110100101000110010010001001010101011100010100011100100010100001010001011100
1111111000100011110001011000110001011101001010100011010001000011100101100001111100011111001100000101
0000010011111100000100100010001111000110100010010100011101010000101000010101000100100011101111110100
0101100010000101111000100111100100100100010100101101100001101100100111010010010010101001001100000110
0100100100110100001011001000001100010001011001110100000110000010100100001000100010100100010001111110
0010001000010011001000011101110001001111001010001011011100111010001100110101001100100100100110000000
1001011011001001100111110100110110100000101000101000100001010001110001100011010001000011001010011111
1100111000101001010001000010010011111100100111001010101110011010000111001001000110110000100110100001
0001000100011010001000101011001000011010010100010010100011100010111000101101110100001110100010010100
0110010111010010100101001000100111010001000101100010111000100110000010101100101101010000100001000010
0110110000010100010101001101001101000100111101001100000110110101111110001110010001000111111101111110
0010001011100111010100010001010000101001000001010111110100100100010001110001010011010100001001000000
0001100100001000010110010110010101010010011111010000000101001001010101100101010111101001001010011111
0100110010110000100001110100100100111010100001010111111101010001010100010101010001101011001010111000
0100000100000000101100000010001100000010000100010000000001000101000100000100010000000010100010000010
