100
0010000101000100010000100001100000010001000100010000001000011000000001111000001100000010000001000001
1010110001010101000110101100101110010100010101010011100101001001000101100001101000110100100110010000
0010111010010101000100100110001000100111100101010100010100100100111001000110001000100101100001001010
0100110001010100101000010101010011001000101001000101000101010010111100101000010011001100100101100100
0001101100010110110011110000101000101010100010101000111100001000100010001011100100001110111001001000
1110000111100010001001101110101101001010111111010011000111100111101001111001010101110100011010011010
0000101000011011100100100000110001011010001000010100010100010001001011010010000100001111010010010001
0111100101000011001010100111100111001010101010010101100101001001001000110100011011101000010100101000
0000101101101100001000101000001000100001001001010001001100100101011110010100100001101011100001000110
1110101001011001110001001011010010011110011001001110001110010001000001000101001011101011011110010000
1000100010011010001010010000110100100000100011100010110000001110111011101001001011100010000100011111
0000110100001000101000011100000101101111000100011010100001111000010011110010001001111111010100110001
0111011101100101101111100010111100100001011101000010000111010011010100011001001101000110010101000101
0100000100110011100010001001000010111100010001111111110111000110010101000100011001010010010001011100
0101110010001000011010111100101000100010010110000100001000011000110100110011100010001000111111001100
0101110111001100100010000010101001001001110100100110101011101011100010001001101101000100100001001101
0100010001100010001111110010100110010101000101101100101000100010000111100100100001110011100100100100
0011001100111011010000010010001001010001100100100100101010101100011100001000110101110000101110010010
1011001110100011110010010001010001001100010101010001100100101001100001110100011001001110100001001010
1000100100100100010111010100100100100011000100001110010001000010100110000011000010000100111100100010
1010100101001001010001001110100100101000111011101000111101111101001000111001110100101001001110010100
1110010100010011001011001100101100011110101000100010100011000001000011001010001001100010000010001101
1000100111100111000010010001000111000000100010010110101001011100111110000010100101101100110101010101
0011001000100001100100010111011000111111001101001010001101000010100001010100100100011001000100011100
0100011010011000011001110001011010000010010000100001101001111010010101001001010011011010001001100010
0001100001010111001011101101011001101010100101111101110010101001000100101010001000010010110010001010
1110001010001000101000000101000100011010101001000100110100000011111000101000101011110010001001011000
1000111110101001000111110000110110101010101011010110100101010111010011101111001100000111100101010101
0010011110011101011000001011010000100010001000010010001100101000100100100011011001110100010001000110
0110110001000001000011100100001011000101111111100001100110010010001000011001001010001001001111110000
0101110100111001010100001101100111000100001000111001111010010001101011000101001010101010011000001100
0000010010000100101001110001001100011101010010000101101101001100010010110001001000101010010011100110
1111011010000010100010001011100100010001000100110100100001001010010110001010100101001010000101100000
0000001001101010001110101001010001100111011011100010101101100001010000100100001010010001111100011111
0011111100101001110000100100001110001011100010001100101100010010011111001001110000101000001001010000
0100001110011101000011010111100110110001001010110001001011000100101100010010000101000101010010001010
0001010001010001001100010100010010010100010010001011011000101001000101110110000110010011000010110010
1111000100010010010101010101001001000111100011100001001010011001010100100000011000001001111110110100
0000111111110100111001000100101100111000001100011110101001011001010010011110010011111100000010010101
0100010001110001000100101001000010100011010001001101100001010010001011010001100100011110101100100100
0111010101001110010101110010101100100111100010000010011011010100010010010101000001010001001001001010
0101010100110001010001000110100101101000101101111010001100010000100100100100110111010100010010010000
0011000100110100011010000100010001001010100001000010100001110111001001001110011000010011100110100111
0001011010010111100100111101001111010010010101010110010110111000100010010111001001101000010010101101
1100100011010001100101010100100011001001001001001100101000011010010010100010010010001111011000100000
0001001000001101110100100010110000010001100010100101110010001001001100101010100100101001011111111001
0111010111110001000010001010011011100010111100010101000111100001011010001010001001001100011000001001
0011000010001010001001110010000100001110001001010100011000110110010001011001111010100010110011100100
0110111000101000111100000111001001110000101010000011100010011110110101110100100010011010000101101010
0000001111001110010111111000100100100011001001111001001110010000110100100010000100001001001000101010
1111100100010001100000101010110110001100010101000111100111001001000110001001111100100100110010001110
0000001001110100101110001010010011110001100100010011110000100010011101110101000101010010001001110000
0111010011110010001110101001001011010111000010111010001110111110000010000001010101101011101000010110
0000100110001001110001001100101000010000101011000010101100100001111001010001010001000011100111010001
0101001010000101000101011100100101001010001001011110100001101100011101001010011110010100010001010000
1001011100100100101101001101000010011101011001001110010111100010011001101100100000011001001101001010
0010001100110010100101100001111000100001100100100001001100010011000010100101100100100100100101100100
0101100010010010010100010111000110101100001000011100100101001001010100010001110011000010010001110001
0001011001001001000111011000010001000011010001100010010101100100111001001010001000011001011110001010
0101000011100100111000010011110011111001000110101001010001110110010010100110100111110100010100101100
1001101100001000110010110110001000000100111000100100010101000111000100110010010000000111100001101111
0011001101001010100101110000100111110010101010010011011010011000111100001011011111011110101111001000
0111100100101001001100001111001000000100111001001000100000110010100001100011001000010000100100010010
0000100101110100011101100010001010111001100001010110010111100100101111011111101011100110110100100100
1110010001100010100101010100111001000100100110010001010000001001100000011000001011001000100101001110
1000101110001011000101000101101100010010001000100101001111010000111111011011111001011011001001011000
0011000010010010010001010101100011110001111010101100010000100111000110010010001101010010010010010010
0100011010100100101010001100101000001101110011100110100100101100010100100100101101001000110010010011
0100111000100110000110000010001111011100101001110111010100101001110001000101100100100101011000100111
0001000101001011110111111001110100010000011100110000010010001010001101011000010001000010000111001000
1110010010011100000100000101000001101110100010001111001001011000100010001110011100111000010100011010
0000101000100001111101100001010110000110101011100001001101111011011001001100100011110111100100100010
0110101101101110101100011110001111010000101000011101100101000110000100101001001001000001101001000010
0001000011100000000010000001100011010111000101111001010001010000100010101010001101010001001010100100
0000101000010111110010111100111001011110011100010010001110011011011010101001010001001010011000101100
1110100111001000010111000110010101001010100010000100100000011101000010001001010110010000110110001000
0100100001000101000101010000100001100100101001110101111011110000011111110100010001001111000010110011
1001011001000100111000011111100111010101100100011100011100010100110001100011111100010001101001100101
0010000001010110000101010000110011000100001111000011000001010110100100101000100011100100100101001011
0100111111010011100100110010010100010101111000111001111111010001001010001110101001000110010101001000
0101000001101001110010011010000101101010001010000010000010010100010001110000101011001001000101010010
0101011001100010000010001001111100101110100011111100101001001111100100011011001000100010111001000010
0101001101000100101111101101100010100010010100100010001100100100010011001000011110011000110001111100
0001101001101001110000101100001010001011001100101000111010001001001011001011100001001110010110001101
1110001100001010100100001110111001010001101000101101000001110011010011100110001001000111010100100000
0000111011110010000111010001000100110111001010100010011100001010010110100100010010110001010010011110
0001000000110100101000100100000010110010010010011010100111001010100100010100100100001100001001010001
0111001010100010011010010011101010011001010111001010100000100010001001000101001001000011111101010100
0101001100101010011001010100010011001000010001001000101100111101110001111001010001110010001000010010
0001001001010001010010010101001001100111111101000111000110010000110110001011000011111010100101101010
0010010010100111000100100100101000010100000001000110100100100100110000101000110100010010010010100010
1000100100001001111100101001001100100100111100110000010101001000001111001110001001011000111001101100
1111001001110000000100100001010100001001000011011110000100010011101000010001100001001111000100101001
0000101010011011110001011111000011101101010100000101111111111010001101010100011111100010010001001011
0110001001001000001110000011101100011001010110110011000100000100111100110101001000100110101110010001
0001110100011100001000111001101001010010010010110010010101110010000010010010010010001100100000101100
1101010111010111100110000100101011010110111010001010100100010001111001001010100111110001101011000010
0101110001000011001101010010100010010010010011101010101011001011000100010010101000000110100110010000
0000100101111010010001111010011100001001010110001010101000101011010011100110101011111000110110101111
0000000100000010000100000010000001111100010000011000100010001000011000000110001000000010000010000000
