100
0000010000000000000000000100000000001100000000000000100000100000000000010000000000000000000000000000
0000000001001000000001000010001000000000000000000000001000000010000100000001000000000000000000000010
0000001000000000000100000010000110010000000000000001000000000000000100000000000000000000000000001000
0000000000110000000100001000000000000001000000011001010001000001000110000100100000000011000000100000
0000010000000001000000000001000001100000000000000000000000000000010000000000000000000000000011000000
0000000000010000011000010000000000000000011100000010000000100000000000001000011000000000001001010000
0011000000000110000000000000100010001000000001000000000100001000000000000000011010000000000001000000
0000000100010000100100000000000000000010000001000000000000000000000000000100000000000000110000101100
0000000001000000000000001000000000100100000010000100100010000000000000100000000001000010000000100000
0000000000000000001000000000001000010001000100110000000010010010001001000000000000000000000100000000
0000000000000001000000010000001001001001000001001001000000000000100000010001110010000100011000100000
0110000000000001011000010000001000000000011000001000000001100100000000001000010000000001001010011000
0000001000000000000010000100000010000010000000001000100000000000111000000000000001000000000000000000
1100000000000010000000100011000000000000000000000100000000000000000000000000001000000000010000000000
0010000000000000000000000000000000000001000000000011000000000011000000011000001010001100000100000100
0010100010000001000000100000000000000000001100100000100000100000000110000000000000000000000000000000
0010001001100000000000001000000001000000000010000000000000101000000000000000010001000000001000000001
0000000101001000000000100000000100000010000001000000011000000000001100000010000100000010001000000000
0100000000000000010000001001000000000000000000000010000001010000000000001000000000000000000000000000
0001001000000111000000000100011010000000111010000100000000010000000000000001000000000000110000000000
0001000010010000100000000000000000000000000000000001000000000000000000010001100000000000000000000000
0001000000001100000101000100000000000000000000101000000000000000000000000100001000000000001000000100
0000000100100000000000010000000100110000000000000000000000000000000010000000011000001100000000000000
0001000000000000000010000000000000000000000000110000000000000000001000000000000000000011000000000000
0000000011000000000000000000001001100000000000000100000000000000000000000000000000000001010000110000
0000000000000110010100000000100000000100000000000000000000001001110000100011100000000000000000000000
0000010000000000100000000000000000001000010000000010000000100000000100100000000000000000001000000011
0000000000000000000100100111000000111000000000010000100010000000000001000000100000000000000000000000
0000010000000000000000000001000000100001000000000000000000000010000000001000000000000000010000000000
0010000001000001000011001000000000000000000100001101000100000000110000000010000000000000110000000000
0000101100010100000010000010000001000010010000000000000000000100000000001000000000000010000000000000
0100000000010000000000000000000000000010000011100000100000000100000000001100000000100010000000000110
0100000010000000010100010000000010000000100000000000000010000100000000000000000000000000000000000000
0100000000101010000000000000000000000100000000010000100000000000000110000000000010000100000000000011
0000000000100000000000000000000001000000000000000000000100000000000000000000000000000000000000000000
0000000000000100000000000100000000001000001000000000000000000000000000011000000000000000000000000000
0001000101000000101100100001000100100000000000001100001000001000000000000000000000001001000001100100
1100000000000000000000000000000000100100010000000001000001000010000000000000011000000000000000000000
0010011010000011000000001100000000000000000000000000010000010000100000000110000011000000100010010000
0010000000000000000000000000010000010000001000000000000001000000100000000100000000000000000000000000
0000110100000000000000000000000000001000000000000010000001000000001000000000000000000010010001001000
0000000100001100100000000000100000100000010001111000000000000000000000000000000000000000000100000000
1000011000000010000000000000000000000100000000000000000000000011000100001000000000000000000000000100
1000000010010000010000000011000000010001101000000000000000010000000011000000001100000000001010000001
0000000010000000000000001000011000000000001010000000100011000000001000000000000000000000000000100000
0100000000100000001000000000000000001000001000000000000000100000000000000110000000000010010000000010
0001000001000000000000000000000000000000100100000000011000011000000100100100111000000000000000100000
0001100000010000001000010000000000010000000000000000000000000100000010000000000110000000001110001000
0000010000100000000010000000000100010001001000100011000010000001001000011000000000000000000010000000
1000000110001000000000000000000000000000000010001000000000000010001100000000000001100000000001000000
0000001000000011000100000100000001101000000001001000000000000000100000000000000000000000000000000000
0000000000000000000000000000000000000000010000000000001000000000000100000000000000001000000000100000
0000010001000000000010000010000000000000000000010000000000110000000000000001000110000000000000100000
0010000000000000000000001000000100000100100100000000010000000100010000000100000100000100000000000000
1000000100100000000000000000000001000000100001001001100011010001000000010000000001010000000001000001
1000100000000100000001010000000000011000001000000000000000011001100000000010000010000000100000011100
0000000011000001100000000000001000000001000010010000100000000000000000100000011110000000000000000000
0100000000000000000010001000000010000000000110000000100000000000000011000001000000000000001100000010
0000000000000000000000000001000000000000000000100000000100000000000000000000010000000000000000000000
1000010000000000000000010100000010000000010000000010000000000100000111001000000000000000000110000100
0001000100000000000000100000000000100000000001000000000000010000000000010000000000011000000000000100
0100000001100000110000000000000000000000100000000000000001000000001000000010000000010010000000000000
0000100000100000100000000010010000000000000000000000000000000001011000001000100000000000000000000000
1000000000110000001000000010000000001000011100100001000000100001000000000000001000001100100000000001
0001000000000100000000000000100001100000000000000000000000001000010000010000001000000000001000000000
0100000000000000000001000000000100000000000011000010000110000000000000010001000000000001000000000010
0000100000000000000000010000000000010010110000110000000000000100000000000100000100000000010000000000
0010001000000001001110000100001000000000000000000100011100010000000000000000100000000000001000000001
1000000100100000001000000000000000000100000110000101000001000000000110000000001000100010000010000000
0001000010001010000000000010000000100000000001100001000000000000000000000001000000101000000000000010
0001000100000000010010001000000000000000000000001000000000000110000000000000010000000000101100000000
0000000001000001000000100011000000000011100000100010001000011000000000000000000000110000000000100001
0000100100000011100001000100000010001000000000100000100100100000000000000000000010000001000000001100
0000000110000000000000000000010010000001000000000000000010000010000000000010000000000000000000000010
0001000000010000000000000001010000000000000000000000000000000000000000001010001000000010000000001000
0001000000000000001000000100000000000100100001000000000000001000000000000000100000100000000000000000
0110000000000000000000000100100000100100000000000000000000000000000000000100010000000000000000000000
0000000000000001110000000000000100000100000000000000010000000100000000000000010000000100000100000011
0000011100000000001100000011000001000000001000010100000000000100000000000010000000000000000001000000
0000000000001110000000000000000000110011100000000000000000000001100000000010000000000010001000000000
0011100001001000000000001100100000001000100100100000000000001000000000000000001011000000000010000100
0000000000000000000000000000000000001010000000010001100000000000011000100100000000000100000000010000
0000010110000000000000111000000000001000000000000100010000000010000000001000001100000000000000000100
0000000000000011100000000000000001100000001011000000000100000000100001000010000000000010000000010001
0000000000010010000000000101000000000100110000000000000001000000000000000000010000000000000000010000
1000000000000110000011001100000000000000000100000001100000000000010000000000010000011100011000010010
0010000100001010000000100000100000000000000000000000001000000011000000010000000000000000000000000000
1000000000000000011000000000000000000001001000000001001000010000100000000000001000000000000000100100
1100100001000100000001000000001000000000000000100000000000010000000000000011110000100001110001000100
0010000000000000000000000000000000000010011010001010000000000000010000000100000000000000000100000000
0000010000000010000010000000000000000000000000000000000010100000011000000100010010000000000011000010
0000000000010000001000000000010000000100000011000000000000000000000010000001000000100000000000000000
0100100000000100001000110000000000000000000000000000000000010001000000000000100000000000000001100100
0100100000100000000000000000100000000000000101100000000001000100010001000000000000100011000010000000
0001000000100000010000000000000000000001000000000000000000000000000000000001000000000000000000000000
0000010000000010000000000000000000000000010000000000000010000000100110000000000001000000000000000000
0010010001000000001000010000001000011010000001000000000000000000000000000000010000001000000000011000
0000000000000000000001000000000010000000100000010001000000000000000000000000000110000001100000000000
0100100000000000110000100100000010000100000000010000000000100010000000000000000000000000000000000001
0000000000000000000000000000000000000000010000000000000000000000000000000000000000000000000000000000
