100
0100000000000100000100000000110010100011010000011100010111100000110100101101111110010100101110110110
0000000000000000000000000000000000010100110000010010111001101011100010011100000100000111111011111110
0010010000000000000010000100000010001010101010101100011100011001100101010101011110100010001101010001
0000000100000000000000000000000000110111101010111010010101111111101001000001111011001010101101010011
0000000100000000000000010000000000110011101010100100110000011111110100000100010011000101110000110100
0101001000000010000010000101100100001010100010010000101110000100110100110001010001011101000110111110
0100000100010000000000000010000000000000011010101010110001101000001010100010010011010100111011011000
0100000000000000001000000000000001000000111000001010111000011111001001001010111111101110110011101101
0000100000000001000000000110001000001000000000000000000101100011100110100001001110010000001100110100
0000000000100000000000000000000000010011001000000000000000000000001000000000000000011101011110001010
0100000100000000000000000000000000010000100000011010000000000000100000000000000000000000000000011100
0000000101000000000001000001000100000010000000100000011000000000000000000000000010000000000000000110
0000000000000000011100000000100000000000000000000000000000000000000000000010000000000000000100000000
0111000100000000010010000000000000111000000000001000000000000010000000010001000000110010100000000000
0010000000000000100100000000000001001010000000000000000100000000000000000000000000100000000100000000
0000010000000000000000000000000100100001000000000010000000000000000000001100000000000101000000001000
0000000000000000100000000001001000100100000000000100010100100100001000000000100000000000000100000000
0000001000000000000000000000000000111000000000000001001000000100000000000000000010000001000000000001
0000000000000001000000010000000010010000101000000000000000000010000000000010101100010000000000001000
1001000000000000110000000000000000000000000000000000110010000000000010000000000000001000000000101000
0001001010010000000001011100000000000001000000000000000000000010000000000100000100001000001000000010
1100100010000000000000000000000000000000110000000100100000001011100001010000000000100001000000000000
0000001000000000010000001010000100100001111000000100000000000100000000000000000000001010100000000000
1000001100000000000000000000001000000100110000000000000000000000001000000000010000001000010000000000
1000100000000000000110000000000000010101101000010000000000000000000000000000100001000000000000000000
1000000001010010000000100000000000100100010010000000000000000000000000000000000100100100000000000000
0000000000000111000000001000010000110000000000000000000000000000000110110000000000011000000000000000
1010000000000100010000000000000000000000000000000100000001010000000010000000001000010000000100000000
1000000100000000100010000100000000000000000000000000000000000111000000000000000000000000000000100101
0000000000100011001000000000010000000000011000000000001000010011000000001000000000000000011000001001
0000110000101000000000000000010000000000100100001000010001000000000000000110001000100000111000000111
1000001000000000010000000100001000000010000000010010000000000000000000001000001100000000000100000010
0100010000100000001000000000000000000010001000100010000000000000000000000100000000000010000000000000
0011000010000000000011000000000000010000000000000010000000000000000000100000001010000000000000000000
1110010000101000000001010000010000100000110000000100101000010001011000000000100000001100000000000000
1110000000101000000000000000010000000000000000100010001010111011100110000000000001000010000000001001
1000001000000000001010000000100011000100000100010000011011000101110100011100000100000000000000000000
1000000000000000000110000000010010000010000110010001010000011110110110000001000000000000000000000001
1111100000000000000001100000000000100000001010000010000000100000010011000101101000000000000000000000
1010000100000000000000001010000000000000000101000000000000000000000000001110100000010010100110000001
1011000000000100010000001000000001000000100100001000101000001000000000001000011000100000000010000000
0000000000000000010000000010001100010000111110000000000000000000001001000000000000000001011100001001
1000100000000000000000000100010101001000101000000110000010000000000010001101110011100100011000001000
1100000000000101000000100011010100010000000000000110001000000111000000000100110011010011000000001000
1001110000000000000100100000000000000010000000000010000100010000000000000000000101111100010100010010
0100100000100010000000010000001000100100001001000001000000000000000100000000000000100000000000000100
0110000101000010000001000000000000000000000000000000000000001000001001100000000000000000000000001100
0010100100010000000000000000000100010000000000000001000000000000001000000100000000100000001000000000
1000100100000000100000000000000000001000010000000000010000001000000000000000000010101100000011000000
1010010000000001000110000010000000000000110100000000100001000000011010000000010000000010000100011100
1111101000100000101101000100000000000000000000000010000000000100000100000001010100100000000011111000
1011010100000000000000000000000000100000000010000100000000001100000000000000000000000000001100100001
0100100101010000000000000001000100001000100001000101100110110010010000000000010000000000100000000000
1001000000000000001000000001000000001000000000000010010001010010100101000000000010000010000000000000
1001010110001000001010001001000000110000100000101000011100000001100000101100000100111001000000000000
1010011000001000001000000001000010000000000100000000000000000000000001011100101001110000010001000000
0101100100000000000110000000000010001000000001010000001000000101000111001101100101010000000001000000
0111011000000000100000000100000000000000000000100000010000100000000000001000100010001101000000000000
0101100000000010100000000001000010000000000000000001000110100000011100000000000000000111110000000000
1011000001000010011001010001000001010000000000001000000000010101010000000000000101000010110101100000
0010100000011010000000000001000000000000000000000001000000100110000111011100000000001001100011111100
0011100010000000000000110000000000000000100001001010000000001010000000000000010000010000010011011000
0100011011000000000100000000000000000000000010010110100001000000000000000000001000000000000000000100
0001110001000000001010000000000000000000000000011101011000100000000000000000000000010000000000001000
0001101011100000000000100001000000000100011000000001000110110010000000000000000000010000001000010000
1110010001000100000000000000000000000000000000000000000010010000001000011000000100000000001001010000
1001001101000000000000010000000000010000110000000000000100100110000101000000000000001000010010000000
0111101100000010000000000000000001000000000000000000001001111101010000010000000001000000010010000000
0001110110000001000100001001000100000001100100000000000001001100000000000000010010000100000010110001
0110011110001000001001101100000000010101000000000000100000010000000000000000011000000000000011101100
0110101100000011000000000100001001010000000000100001010000000000000100010100000000000110000000100000
0111111011101010000000100111000001100000000000001100000000000000100101011010010000000101101110000000
0101001111000000001000110101110000000000000100100001000000000000000110001001011000100010010100111000
0110010010000010100000000000000000000000000000000000101000000000000000000000101100000000011101110100
1110100001000110100000000000000000000100000000000000001010000000000001000011100000000100010010001000
1100000100000000000010000010000000000000100000000010000001000000000001000011101100011001000100101000
1101011101101001000000000000000000000100000110000000000001001000000010000010000100000010000000100000
0011001010001010000000000010001000000010000000000000000000001101000000101000000000000000000000000001
1101000001100001010100000000001000000000000000000000000000100100101000100000010000000001110000000000
0110001101000000000110000000001010000000000010000000000000000000000000010000100000100100010011110001
1100101000100000000011000000000010000000100010010010000100001000000000000100011001111100000100000000
0001111011000100000000000100000000010000000000010000100111000011000000000000001110100100010000100000
0111001000001100000000000010000010000010000001000000011010101000110000000000000000000100111000000100
1101011101101000011000010100000001101001100001000000000001011010001000000000010010011000011000000000
1001000011111000000100000000010000101010000001100000000000100111111100000000010000101000010001101100
0110110011011000100000000000001001101001000001000000101100000010111100000000000000001000111001001000
1010001011000000001000100000000010001111011000000000001000000101101101100011001000001001001000001000
1011110010010101000010000000010000001010000000000000000001000000000100010001000000100000001001110100
1101100011111100001000010000000000000000001000000000000011010001100000100011000000000000000111000000
1010001101000110001000000000000000000100100000000000000000000010000000110010000000000001000000100111
1000101000111000000001000000000100010110000000000000000000001000000000001000000010000010000000100010
0010110101001010000000001000000110010100000010000000100000100000000000001000011101000000000010000010
1100010001111100000000010000000000010000010000100000000000000000000000000000000000010000000000000001
0110111010010000000000010000000001000010000000000000001000100000010000100000000100000000000000010001
1011010101110000000000110011000000100110100001000000000100000000000001000000000001000000001010000100
1111111011110110010000000000010000000011000000111000000000000000000000000000000101000001100101000100
1110100011010000001000000000111000010101000010010000010000000010000100000000000100010000000000000000
1101100101101000100001100000000010011101000011000000010010100010001000000001010000000000000011010010
1000011001100110011011100000000000010111000101100100000000010110000000000000111000100010000010011000
1010100001100000010100010000000000000100100100000011011000011011000000000001001100100101110000110100
