100
0001001000100010000000000000000000000000000000001000001000000000000000000000000000000000010000000000
0000000010001000000000000000000000000000000000100000100000100000000000011111000000100010000001000010
0000100000000001000000000000000000000000000000100000000000000000000000000001000000000000000001001000
0000000000000000000000001100000000001000000000000011000000000100000100000000000000010000000000100000
0011010001000000000011000000000000001010100001000010010001000000010001000000000011000000000100000011
0000000000000001001000000000000010000000101000000000000000000000000001000100000000100000000100000000
0000000000000000000001100000000000110100000000100001000000000000001000000000000000000000100000000000
0000100001000010000000000000100100000001000100000000000000010000000110100010000001000100000000000100
0110000000010000000000000010001000001000000001000100100010000001000000000000000001000001000001000000
0000010010000000000110000000000000000000001000010000001000001100010001000000000000011000001000000000
0000010000100000100000000001000101000100010000000001000010000010000001000000100000000000000010000000
1100001100000000101001011000000000010000000000000000000000100000100000000000000000000000010100000100
0010100000000000001000000010000100000000000000000010000000000000000000100001000000001100010001000001
0000000000000001001010100000000000000000000000000000010000000001000000000110000000000000010010001000
0000010110110000000000100000000000000000000000001000000000001000001001000000100000000000000000100010
0000010000100110010000000000001000000000100000101000100001000000100000110000000010011000100100000110
0000111100000000000100000000000000000000101000000010000100000110010010100000010010110010000001000000
0000000001001000000000000000000100000000000011000000000000000010000000000000000000000000000010001001
0000100000000000100100000011000000011001000000000000001000011000001101110100001100000000000000000000
0000000000100100000001000000001000010010000001100000000010000100000000010001000000000000000000000110
0000000000000000000000010000010011000000100000000000000000100000000000000000010010010000000000000000
0001000001000000001000000001010000000000000011000000000000000010000000010000000000010100000000000000
0001000000000001000000001000000010000100000000011000000001001000000011001000000010000001000000111100
0000011000100000010000100000101000100000000000000000000100010000000000100000011010001000000000000000
0010001000000010000000000000000000001000000000000000000010000101000000110010000000000010000000000110
0000001001100000100001000001010000000100000100010000000000100000010000000000110001000000010000000000
1100001000010100000000000000000000000001000001100000010000001000000000000100000001000000000100010000
0000000100000000011110000010001110000001001000000000000000101100011001100000001000010000010001000111
0000000010010010000001000000001001100001000000000100010001000001001100011011000000000100000001100000
0000100000000000000000000001000000010010000000000000000100000001100001001000010000000001001000000000
0010000000001100000000000000010000011000100010001000100001000000000000000111000000000001000000000010
0001000000000000000100000110000000000100100000100000000000000000011000000000000000000000010000001100
0000000000000100111000010000100000000100000000000000000000000110000000000000000000000000110000110001
0000111000000001100000000000000000000001000000000000001000100000000000100010000000000000100000000001
0000000000001000000001000000110001000011000100000100000010000000000000000000100000000000101000000000
0001000000110000000000000000000100010100000000000000000001000011000000010100000000000000000000000001
0000000000000000000011100000000000000000010011000000000001000000000000000000001000001001010110000000
0000100001000010001000010000000010000010000000000000010000000000000010000000100000000000000000000110
0000000110000000100011000100000000000000000000000000000100000000000000100000000000000010001000001100
0001001000100000001100100000000100000100000000000000100000000110100100100000000010001000001000100100
0000000000000000000000000010000000100000000000000000000000000000001000100000010000100000000000110000
0000000001000110000001110010001000000000000000000000010000000001000000000000000000000000000100001000
0000100000000000000000011000000011000010000100000000000000000000000000100010000000000000000000000000
1000000010100000000000000000000100000000000001000000001001100000000000001000000100001100001000000000
0011000000000000010000000000000000000100001000000000001000000000010000000001000000000000000000100000
0100000101001101000000000000000000000000000001000000000000000000000011000000001000000000000000000000
0000000000000000000000000000001000000000000000010000011110000000000000000010001000000000000010010100
0000011100100000100100000000000001100001000100010000000000100000000001000000000000110000000000000000
0001000000000000000101001111000000000000000000000011000000100000100100000000000100000011000000000010
0001000011000000000000000000000010000010001000000000000000000010000000000000100000000000000101001000
1001001100000001101100000100000000000010000000000100000100100000100000110000001000011000000001000000
1010000000011110000000000100010100001000000000000001010001000100001001000001100000000110010000010000
1000100000000000000000000000000100100010010000000000000000010000000000000000000000000001000000100000
1100000000000000010000010010000000000000000000001100000010011000000010000000000000000000001001000000
0001000000000000100001000000000000010000001000000000000010000000010000000000000000000000100000000000
0000000000000111001001001100000000000001000010000000000010000000000001000011000000000011000000000000
0000000000000000000000000000000000001000000000000000000000000000100000000010000000001100000000000000
0000100000000000000000100010000010000000000000000000011100000000000000000000100000000000000100000000
0000010000000000000000000000100000010000000000100000000000000000000000100000000000011000010001000000
0000000000000000000100010001000000000000000110000000001000000100000000000100110000000100000000010000
0010000100000110010000000000000011001000011001100000000000011001101001000000000000000101101000000100
0000000000011001001000001000000000001110000000001001100100000000000010000000000000000100000010000001
0000000010000000000000110000000000000000000000001000000000010000010000000000000000110000110100100000
1100000000000000100000000000000000110000110000000010001001000000100000000001000000000010000000000010
0011000100000000000000000010000010000000011100010000001000000010000000000100010000000000001000000000
0000000000000000000100000000000000001001000000000100000000000001100000000000000100000100000000001100
0000000000000100000000000110000001000100000000000000010110100100000000001000000100010000000100000000
0000000001010001011000000000111000000000100010001000000000001000000000000000000000000000000100011000
0000000000000000000000000000000010010000000010000000000011000010000000000001100000100000000000000000
0110000000000000000000000000000000000000000000010000000100000000000000000100000001000110001000000000
0000100000000000010000000000000011100001001000010000000100000000000000000010000000000001100000000000
1000001000000000000000001100000000100000000000000000000000000000000000011001000000001000000100110000
0000000010000000101100000000000000000010010100001000000000000000000001000100000000010000000000000000
0100000000000000000000000000000000000000010001100000000001000001111100000010011000000100110000000000
0000000010000001000000000110000000001100000000110000110000000000000010001000000000000010000000000000
0000000000100000000000010000000000000000100000000000000000000000000010000000000000000010100001000000
0001000000000000100001000001000000000000000000000000000000000110000000010000100010000000001000000000
1100000000000010010000000000000000000101101000000000000010000001100010000000000010100000000010000000
0000000001000000000100100000000000000000000010000000000000000000000000000001000000001000000000000000
0000010000011001000000000010100000000000000000100000000001000000000100000000000000000000000011000000
0000010010000000000011000000000000000000000000000001000000000000000000000110000100000000000000000000
0000000000000000000000000001000000010000000000001000100010110001000010000000000000000000000000000000
0010000001001000000000000000000000000100000000000010000010000101000000000000000000000000000000000000
1000100100000010001000000000000000100000000000000000011000000001000010000000000001000000000000000000
0000001010010000100000000000010000001000000000000011011000001000010000000000100000000100000000000000
0100000000000100000000000000000100011011000000000000011001000011000001100000001000000000000000000000
0100000100000001000010100010001000000000000000000000000000000000000100000001000000010000000000000000
0000000000100000000000000000000000000000110000010000000000000010001100000000000000000000000000000000
1000000010000000100100011000000000110000000100010100000000000000100000100010000010000000010000000000
1000000000011000000100000000010000000000010000000000110000000100000000000000000000000100001000000000
1000000000000010000100000001100000000001000000101000000000000000000000001100000001000001100000000000
0000000110100000010000000000000011000000000001100000000000001000000000100000000000000000000000000000
0000000000000000000010000010000000000000111000000000000000000000000010000000011000100000010000000000
0100000000000000001010000000000000000000000000000100000000000100000010000100000100000000000000000000
0100010000001000000000000100000000000000000000000001000000000010000000000001000001000000100000000000
0000000000001000010000000100000001100000000010000000010100001000100001011000111000010000000000000000
0000000000000000000000100000000100000000000000000001100001000001111000000010000000000000010000000000
0001000001000000000000000000000000000000000000000000000011000000000000000000000000000000000000000000
0000000000000010000100010001000011000000000000100000000100000010000000000100000010001000001000000000
0000100000000000000000000000000000000000000000000000000000000000000000000000000000100000000000000000
