100
0000000001000100011000000000000000001001010100000000000101100000000011001001000000000000000011011000
0000000010000000000000000000100000000000000000000000100000000001000001000000000000000000000001000100
0000000000000000000100000000000000100010000000000000000000000000000000010000001000010000000000000001
0000010000000000000010000000000000000000000000000000000001000000000010000000000001000000000001001001
0001000010000000000000000000000000001000011100000000000000000010000000000000010000110010000000000001
1000000000000011000000000000010000000010000000000000100000000000000000011000000000000010010001000001
0010100010000001000001010000000000101000000000000000000011000000000000000000000110000000000100001001
0000000001000000000000010000000000000000010000000100000000000000010000000000000001000000000100000001
0011000000000010000000001000000000000000000000000000000000000000001000001000000000000000000000100000
1000001001000000000000000000000000000000000100000000000000010000000000000000000000000000000000000000
1001000000000000001000001000001100000000000000000010010000010000000000000100000010000000000100000000
0000010000000001000100000001000000000000000100000010000000000101000000000000000000000000000011001101
0000000000000000000000000000000000000000000101000000000000000001000000001000100010010000000010000000
0000101000010010000000000100100000000000000000000000000000000000000100100000000000000000000000100000
0000010000000000000000000000100000000100000000000000000000000000000010000001000000101000000001000000
0000000000010101000000000000000000000000001000010000010000000000000001100000000000000100000000100000
0000000000000001010100100000010001000001000100000000000000000000010000000101100000000001000000000000
0000000000000000001000000000000000000000000000010000010000000000000000010000110100100000000000101000
0000000000000000000000001010001000000000000000000000000000000010000110000001000000001010000100100011
0000000000010000000000000010000000000000000000010000000000000000000000000001000000000000000101101000
0110000000000000000000010000000000000000000000010100000001001100000000000010000000000010000010010000
0000000000000000000000001010001001000100000000000000000000010000100000001000000000000001000001000000
0000001000000100000000000001000000000000100000000010000001000000000000000000001100000000000000000000
0000000000100000000100000101001000001000000000000000000001000000010000010001000011000000100000000000
0100000000000001010010000000000000000000000000001000000000000000000000000000000000000000000000000000
0000001010000000000000010010000000000100000100000000000001000000000000000000000000000000000000000000
0001010100000000000000000000000000000000000000000100010010000000001000000000000001000000000001000000
0110000000000001000001000000001100100000000000000000000000000000000000100110000100000000011000001000
0001001000000000000000000010000000000000000101010000000000000000010000000000010000000100000000000000
0000000001000000110000000000000010000000010000100000000000000101000010000001000001010000110000000000
1001101000000000001100011000000000000000010000000000000000010100010000000000000000000000001100000000
0010010000000010000000000000100000000000110000000000100000000001000000000000000001010010010010000011
0010000000000010000100000100000000000110000000000000000101001000000100000010000000100100000100000000
0000001000000100100100000000000000000000000000010100100000000000000000000000000100000110000001000001
0010000000000000000000000000000101001000000000000000100000001000000010000000010000000000000000010000
0000101110000000010001000000000000001000000000001000000000010000000000011100000110010000111000000000
0000000000000000101001010010000000000001000000000001001000000000000100000000000000100000000010110000
0000000100000001000001000000000000000000000000100000000100000001010000000000001110000100000000000000
0000000000000000000000000000010000000000000000010010010000000000000000001000011000000000000000000000
0000000000000000000000000100000000000000000000000001100000000010000100000011000000001100000100001000
0001100000000000000100000000001010000000000000000010000001000000010100000011000000000010000010010000
0001000000100010000100000010000010010000000000000001000000000010000000000000100000001000000100000010
0000001100000000010000000000000000000000001000000000000000010000010000100000100000100000000000000000
0010000011000101000001000000010000000000110000000000000000000110000100000001111000000001100000000000
0010000000000000001010000000000000000011001000001001100000001100000000010000000001010000100000100000
0000000000100010000000010000000000110000001100010000100000000000000000100100000011000000000000000000
0000000000110000010000000000010000010000000000100000000000000000000100000000010000000000000000000010
0000000000000000000000000000000001001100000100000000000000000010000001000000000110000000000000000000
0000000100000000000000000000000100000000010000000000000010010000000000000000001000010001000000000000
1000100000010000010001000011000000000000000000000100000100000010010000000000000000000001000100010001
1000000000000001000100000000000000010000000000000000000000010100010001000000000000000010000000110000
0000100100000000000000000000000001000000000000000000000011000000000000000000100000000000000000000000
0000000000000000001000110000000000000100000100000000100000000000000000000000000000010100010000000000
1000011000000000010000001000100001001000000000000000000000000010110000110001000000001010000000000000
0000000010010000100010000000000011000010000000000000000000001010000000010000010000000000000000000000
0000000000000001000000000000000000010000000000000000000000010000000000000000001000000000010000000100
0000000000001001000000010000000000010000011000000000000000000000010000110011100000000100000000000001
0001001001000000000000000000000001110100100000000000000001000000000000000000000000000000000001000000
0000000000000100000000000100100000010000000000001000000000000000000000000100000100000000001000000000
0000000000010010000000110000000000010100000000001010000000000000000010001000000000000000000001000000
0000000010100100000000000000100000100000000100000000100000000010000000000010001100000000001010000001
0000000000010011000000000100010000000000000100000100000000001000000000000000000010010000000001001000
0001000000010000000000100100000000000000000100000001000100000001000000000001000000001000100000000100
0000000000000100000000000001000000000010001001000010001000000000000000000110100000000000000000001000
0010000000000001000001000111000101000000000000000000000000000000000001000000000000100000000000000000
0000000000000000000000000001000100000000000000001000100010000100000011000000000000000000001000000000
0000000001000100010000000001000010000000000100100001000100000000000000010000000000000100000010010000
0000000000000001000000010000000000001000000101000000000000000010000000000000000000000010000000000010
0010010000000011000010000000000000100010000000010000000000000000001100000001000100000110010010000010
0000001000000000000010000000000000000001000000000000000000010000000000010000000010001000000000000001
0101000000000000010000000010000000010000011000000010001000000100010010000000001000000010011000000000
0000100000000001100000000000001000000100001001011000001100000000000000000000000100000100000010000000
1000000000010010000000000000010111000010000000000000000000000000000000000000010100000001000000100000
0000000000000000001010000000000000000000001001000000000000000000001000000000000000000000000000000100
0010000000000000000000000000000000000010000001000000000101000010001100000000000000010000000000000000
0001010000000100000100000000001001000000000000010000000000000000000000000010000000111000001000000000
0010000101000000000000000000101000000000010000101000011000000001010101000000010000011000000000000000
0100000000000000000000000000000000000010000010000000000000000010000000000000010000010010000000000000
0010000000000100000000000000000011000000000000010100010000000100001000010000000000110000000001000001
0000010001000000000001100000001100000100010000000000100000000000101000001000000100000000000000000000
0010000000000000000000000001000000000001000000000000000000000001000000000001000110010000000000000000
0000000000000000000000000000000100000000000100000000000001000000000000000101010000000001000000000000
0000000000000000010000110000000000000000000000000010101001000000000100010000000010000000000100000000
0000100000000001001000000001001000000000001110000000000000100100000000000010010010000000000000000001
0000010010000000000010000000000100000001011010000000000001010000000100000000000000000000010000000000
0000010000000100000011000000000000000000000000000000000000001000000000000000000000001001000000000000
0000000000000000010100010000000000100000010010000000010001000000000010000010000100000000011000000000
0100010011000010000000000000010000000100000010000001000110000000000000000000000000000000000010000010
0000000000010100000000000000110000000000001000000000010000000000001000001000100000000000010000011000
0000000001011100001000000000001000000101000000000100001000001000000000000000000000000000000001000000
0001000000000000010010000110000000010000000000000000000000000000000000110000000000000000000000100000
0000000000110000000000000000010000000001100000010100001010000001000000000000000000000001000100000000
0000000000000000001000000100000000001000000000100000000100000000000000001000000001000000000000000010
0100000000000000000000010000000100000001000100000000000000000000000001000000000000000010001000000000
0000000000000000000010001000001000000001000000000000100000001000001000000101000000000001101100001000
0000000011100000000000000000000000000000000000000100000000010100000100011000000000000000000010000010
0001010000000001000000010000011000000000000000000010000000100000000000000000000000000000000000000000
0000000100010000000000000000000010100000000010000001000010000010100000000000000000000000000000100000
0010000100000000100000000000000000000000000000100000000000010100001000000000000000000011000000010000
0111010010101000000000000100000000000010000000000000000000000000000000000000000000000000000000000000
