100
0000010000100010001000000000010100010101111001100110011001001111001100011101111010111011001011101010
0000000000000010000010001100100010001000000000110001100000111111111100101000010011111000000001100000
0000000000000000000001000000000100000010100100000000000000000000000011110100000110101100101001101000
0000000000100000100000010011000000000000000000000000000001000010000000010000000001000100000000000000
0010000000100000010000100000001000101000001000000000000000000000000000000000000000000000000000001000
0000000010000000100001110010000010000100000000000000010000010000000100000100000100110000000001001000
1000000000000000000000000010000100000001000000000000000000000000000010000000000100000000000001011000
0010000010000000000001000000000000000000000000000000000000000000011010100000000011000000000111000000
0100000000000000000100000001000000000000000000001100000000000100000100010000001000010000000001100000
0000000101000000010000000000000000001110001000100100010100000000000000001000000000000000100010000000
0000000001000000000000000010000010011000000000000001000000000000000010000000000000100000000000001000
0100000110010000110010100000000010011000000000000000000000000100100010000000100000000000000001000000
0000000000000000000010000000000001100001001000000000000010000011000000010000000000000000000010000000
0001000000001010010000000100000000000001000000000000000000100000000000100000000000100000000000000000
0000000001000010000011100001000000001010000000000000010000000000000000000000100000001000000000000010
0100000000000000000100000000000000000010000000000000000000110000000000010000001000010000100000000100
0000000001001000100000000000000000000000000000010000000000010000100000100000000100010100000100001000
0000001001000000100000000000000100100000000000000001010000000000010000000001000100000001010000000000
0000000010000000010000000010000010000000000001000000000000000000001000000010000000000000001000000000
0100000000000100000000000000000001000000000000000000000000010000000000001000110010000000000000000000
0000010000000000000000000100001001100000000000000000000000010000000000000001000001001001010100001000
0100000000010001100010000000011000000100000000010000000000000011000100000010000000000010100010010000
0001000000001010010000100000110100010000000000000000000000000000000000000000011000000100000110001010
0000001011000010000000000000000000000100110000000000000000000000000000000000000000010000000001100000
0000000000000000000000010100000100100000011000011000000000000010000000001000000000000000000000000100
0100001000000000000010100010000000000100000101000000010000000000100000000001000100000000000001010000
0000000000101100001000000100000001000100000000000000000000000000100000000000000000000010000000000000
0010100000000000100100100100000000100001000000000000000010000000010010000000010001000010000001100110
0000001100000101000000001010000000000000000000010000000000000000000000000000000001010000110000000000
0000000000000000001000000100010000000010100000000000000000010000010000000010000000000000000010010010
0000110001000000000000010100000010101000000000000000000000100000000000000010000000000000000000100000
0000000000000011000000100000000001001000001000000000100001100000000000000001011000000000010000000001
0000000101000000000000000000000000000100010001000010000000100001000100000100010000011000001000000100
0000000010000000000000000000000000000000001000001000000000001000010000100000000000010010000000001001
0000001010000111100000000000101000000000001000001000000100000000010000000000000000100000100000010000
0000000000000000000000000000101001001101010001010000000000010001100010000011000000010110000000000100
0000000000000000000000000000000000000000000000000010010101001000000000000110000010001000000010000000
0010010010001000000000000010000000001000000000100000000000100010000000100000010000000000000000000000
0001001010000000100000000000000000000000100000000000000000000000000000100000001000000010000001000000
0000000000000000000000000000000010000000000000000000000000000000000000100000000001001000000010000000
0000000001001000000000100100101000000001000000101100000100000001000000000000000110000000010000000000
0000100001100010000010000000000000000000000000011000100000000010000000001001000000001000000000000000
0001000000100010000100000011000000000000000000000000010000000000111000000010001110000000000000000000
0000000011001000000000000000000000000100000000000001000001010010000100000000000000000000000000000000
0000000000000000000010000000000000000100000000000000101000000100000000100000000000000000001000000000
0000000000000010010000011100000000001100000000010000000100000000001001000000001000101000000000100001
0000000000000000000000100011000010000000000000000000000000010000000000000000001000000001000010000000
0000001000100000000000000000000001000001001000000000000000000000000100001010000001000100000001000000
0000001000100100000000000000000000010010000000000000000000110000000001000000011000000000000100000000
0001011000001000000000001000000000000100000000000000000000000000010000000000000000100000000000000000
1000011000000000000000100000100000000001000000001001001000000000010000000100000000000001000000000000
0000000010000000100000000001000000000000000000000001000100000000100000000000000001000000000000000001
1000000000000000001110000000000100100010100100000000000000100001100100000000001000000000000000001100
0000000000000000000100000000000000100000011000000000001100000000000000000000001000000000001000000000
0100000000000000011000000100000000000110000000000000000000000010100000000000000010000000000000010100
0100010000000000000000000000000000000000000000010010000000000010000000000010100000000000000000000000
0001000000100001110000100000011000100000000000010000000000000000000110000000000010000000000110110100
0100000000000000100100000000000010000000000000000010000000000100000000000000000000001000001000110100
0000000100001000000000000011000000000010000001000000000000001000000100001000000000000000000000010000
0000000000000100000000001000010000000000000010010000000000000000010000000000000100010000101000000000
0000000000000100100100100000000000000000000100100000000000101000000000001100010000001000010000000000
0000001100000000000001001000000000000000100100000010000000000100000101000001000000000000000000000000
0000000100000000000010000000000101100101000000000000001000000000000000001000000000001000000001001000
0000000100000000110100000010000100000000000100000000000000001000000000010000000110000000000000000110
0000001000000000010000010100000000000000000000001000010000100010000100100000010000100001001000000000
0010000000000000000010000010100000010000000000000000000000000100000000000001000000000000000000000010
0000000100010110000000100001000001000000000000000000000000000010101010000000000010000000001100010000
0010001000000000010000000101000100000000100001000000000000001000000000001000000010100000000001001000
0000000000000110000100000000100000110000000000000000000010000000010000000001000000000000000000100000
0000000100000001100000000000000000001000000001000000000010000011000010000000000000100000000100000000
0000000000000000000000000000000110100101100011000000000100000100000000000000000001000110000000000000
0000101000000010000010010000000010000000001000010000000000000000010100000000000000000100000001000100
0010001000000000000001010000101000000000000000000000010000000000000000000100000000000000001010000000
0100001000000000001001000010000010001000000000000000000000000010000010000000000000010000000010001000
0110001000000000000000000001000000000000010000000000000100000000100000100000100000001010000100001000
0000000000000000000001000000000000000001001000000100000010000000000000000001000000000000010000000000
0011100000000100000010000100000000000000111100101000010000000001100000000000000000010000000000000000
0000000000000000011000001000000000010100100011010000110000000000000001000100001000100000000000000001
0000000001000000000101010000000100001100000101000100000011000100000000100001000000000000001001010000
0000000000000000000000100000000010000010000000000000010000000110000010100001001010000000000000000000
0000100000000000000100000010000000000000000001000000000000000000010000000010000000000000000000000001
0001000000000000000000001000000100000000000000000000010000000010100000000100000000000000001100000000
0001000000000010001000000000010000010001000000010000100100000000000001000010010000010000001000000001
0000001010000000001000100000100000000000101000000001000000000000000000000000000000000111100000000000
1000100010101000000000000000000000000000100100000010001000000000000000100000000000001000000100000000
0000100000100110100000100100001000000000000000000000100001100000000000000100000011000000000001100000
1000100000001000000000100000100000010010000000000000000000000000000000000000000100001010001000010100
1001000000000000000010001000000000000100000100000010000000000000000100000011000000000010000000000000
0000000000000100000001010000000000001100000001000100000000010000000100000101000000000000000000000000
0000000010000000010000001000100010000001110000100000011000000010100000000000001000000000000000000000
0001010100000000000000100000000000000000000000000101001000000000000000000010000001001000100010000000
1000010000000000000100000000000000000000000000000000000001000000000100000010001000000000000001001000
0000100000000000000000000000000000000000000000100000000010000000000010000010001000000000010100000000
0000000010000000000000000100001010000000000000000000000110000000000000010000001000000000100001000100
0000000100000000000000000000000000010110010010000000001000000000000000111000000001110000000000000000
1000000000000001000000000010101010010000010000000000000010000000000000000100000000000000000000010100
0000000000000000000000000010001000000000100000000000001000100010000000100000000000000000000010000000
0100000000000000000000000000000000000000000001000000000001000110001010000000000000000000000010000000
1000000001000010011110000000000000100000001110010100000000100000000000000001010110000000001100010000
0000000000000000000000000000001000000000000000000000000010010000000000000100000100000001000000000100
