100
0000001001110000100001000010001000001000100001000100000001000000100011000000010001000010000001100000
1111101100010110100100010100100001010010010100010100101101001110101001001111000101010011001010001010
0100001001010010001101100101010110010111010011100001111101010000100100010000111101001001010010011110
1001110010011001111011001001111110100100010000011111110001001011110011111010010101100101010110100000
1100010100100010001110100100100010101001101111010000100011101010001001101011000100110101010000101101
1011000101010100101000010010101000100100010000010010010100001000101101110010010110000100011101100010
1000111001010010100011011000100101110010010110101010000101100101000101000101100111111111100010111001
0010010010001010011110011111010010001001000101100011111100011010001000011000100100000010000010001100
0101000100101000100010110001100100100100110100001100000011000100010111101010101101111010110100100010
0000111001001111001010100100010100110010110101110001001101001000110001010010001000100010010001011000
1110001001010000010010001010010001000100111100101100100010101011000100100111110110101101001110000101
0000110011010101110111011001001010001001100010000010011000101010011000101000000100100000100100010011
0111101010010011010010100001100100111011001010111011000100001000010011100001101000111010110010011000
0100000010111001001011101100110110001000011001000001001110111111100100011010100101000100101000000110
0101001110001000001000100101000111100111110010010010010001100001000101001100010001010101000111111000
0000010001100111000101001001011000100100000111001100100100001100001001101001001110010001010001000101
1111100100010000110100010011001010010101111000100001001111111010110010001101010000111110011100010100
0001001110001001010010010101101001000100010010100111001100000011000100110001010101000100100011110100
0100010001010010001001010000100100111011000110011100010001111010011110001010010010010100101000010110
0011110101000010100010111110001010001000111111001001110001000010100001101010111010110101101111010000
0100010100101100011010000001110001100010011000010010001010001100101001001010010010100100100100011111
0101010010011111010100110110000101111111010011100100101001001001101101010011010010010010001001110000
0001001001000010011001100100011000100100010010001001001010001011100100010101000101010110110001010010
0111100100111010101010001001110100100010110100110010010010111000100111110001110010010001100110010100
1000010001100010111010110010000110101000100110000100100100001100100000001010001100101100010000100100
0011001110101010000010010100110100100111001001111010001111100101111111101010100101100011011110010010
0100101000101101011100000101010001010001001000100001110001001100000110001000110101001010011000100100
0001101010100001100010111000001110001100011010110100100101011011110100101010100100010010100011001001
1101101010011100001011000111101000100011111010000110101001001000000101011111001110110110001100001011
0000101010100011110010010010001011100100001001111110100100100101111100001000100001100101110001111000
0111101010101001000100011001011000010101101100100000110010010001000011101010011001001000100110001110
0011000010000101001000110001001101010001000110100011111001001111001000100010001101011010010000010000
1000111111111100011000100110100011011110011000101100001010100001101100111101100001001001001111010111
0001000010000010100011001000011010010000100011100000100000011100100010101000011111011100100010010000
0011011001010001001100011011001000100111001100011110111100100010011010001010000111000010010000111100
0110000101001100100010100010011101101101100001000011000011101001001001101001100101111000111101000010
0001010101010001011010001100100011100100011111111001011000100100101001000100110001000111000010010100
1100100100010111000011101001001011110001001100010010010110010110100010011010111000010010001000100101
0110101011100001010100010010101000101110010001000100011000100010011100100010000111100110011110101000
0000100100010101001101000110100100100000100001111001111110011011010001001011110110010000100001000110
0001010001011000100100111100010010001110100111000010000101011001010001010001000100011101000100110000
0010001111000100010010000101001001110001001000001100110001001101000110010010011001010111001010011111
0010100000110101011011010100100011000101011001110001111101001101101000110110100001001011011000010000
0100011110100010010011100110111110011101000011000010000100010001011001110010001110100001000101110110
0110010000100100100100001000111000101100111110011100100011110110000010001001010000011100110100000100
0001010111001001101001110001100011000010010001000001111010000100011110100100100011010000100111111101
0101010001011100001011000111101101101001010101111110001010111100100000010101001011001011001000000100
1001001011001110111000011000100010000101010100010000101010001001001010100100100110100010010001101110
0010001001100001000110100010011000111101000101010111000011100011001101101110110001110100100110001000
0100110100011101010111101110000101000101111010010001000100011100010000100000100110001100101100111001
0010010011001001010001100001110011010001000100110010111001001001010110011111101000100000100010000100
0011000000100010010100111011100010001010010010001000100010001100100100100001000011111111011011110010
0111111110011100011110001010101011100110100011101110001100110010001001101100111110000110000010001010
0001000000100001111001100011100100110010011000001011010001000001110011001010010001010001000010101010
1101010111001110001000011100010010001010001111110000110110010010000111100100100101001100001100101000
1001001000100010101010000101001000100001101000101010010001011010000100010101101001100101110001101111
0010011010101000100011110100100110111110001010100011001001001010111101000101001010001010000111100000
0110110010111011111100000110010011000100110010101101001100101010001001111101010010010000011000011100
0100100010000100000101111000100100010010010110100000101001001001101010001001010111000101111011001110
0010110101001101110100010011000101010001000110011000100010000100100010100010010000111010111000100000
1010010001100101100011010110011100101101111010000110011110111010011110011010001100110000100100111101
0011010001110001001100010001001110010000100001110010100010010001010001000101100010010110011101100011
0100011100001010010001111100100001010011110100001000101001000101000100110011110001010001000100001000
0001100101100100100010000010010101001001000111100111100100111100111010001000001001011010110011110110
1111011111010010010100001001011001000100011000110100010010000001000011100111100101000010001000100000
0110000100001001000100111101001011110011110010100101011001111110011000010100010100111010100110101111
0000110101000100111101000000101000100110001010001001001101100001000111000101010001000100100100001000
0111000100110010000101000001001110101000101001110010100001101100100001011001011110010001001111110010
0011011010011010001100101010010000101010101100110100011110100010011000110010010001001111011100010010
0001001000101001100010100100110011100011000010100101001100011001000110110010100101100010010001000100
1101100101000100011010010001000100010111100100101001010001000010001000100110100100011010100111111101
0001110001010011000011010001011001001000010101100011010010111101000101001000101111001010010010100001
0110001001001001010011010010000100100101000100111110010110001000101001000101100001101011001001001110
0000101111100100111101001101100100110001111101011100010010101010100010011100010100100010101101010001
1110100100010010010000101000100010010111000101000010101010100010110100101111001001011111100001000100
0001110101000110001010101010111001001110010100001010001000111110011100111000100010001101111111101010
0100010101111001100010101010010011100100100011110001101111000011000010001010010100100001000000011110
0011000100010000010110001001000100010110011000100010001000001011111001100011001101111100101101000110
0000101011000101011111110001111001010101010110001100010011101010000100010100011100011110100011110000
0110110001101010010001010110000101010010010001110101100101111001010010101000100011000110010100001111
1100100100111000110101100010100101001001010100100001101010000100010100111011001000100001010101101000
0001001010010011000100101010010101100101000101000001100010110011010101011000100100011101000100100010
0110100001001001001110010001010100100100111101011101111000101000110001000100010101000001111010011100
0100011101000101010000100010010010010001000101000010000101100110001110010010110011111111100011000101
0111001100110100010111000110001000001110010100111010110011000111101100010000110100001000101001110100
0001100001000101110110011000101111001100110110000010001001010000100010101111010001101010100100100010
0010000011011011000111001011110000111001010001111100001001001110111010100001011110100010010010000100
0010110100010000101000101000110110011001110000100011000100010000110010000101000100011011011011111000
1010011001100010100010101110010001010011001010101000110011110011000010111100010101001100010010010010
0001001100101110011100100001001101000101000100100110010100010110011101100011010100100001100100001001
0111000010001011001101010100010000111011010110010101000101010011001000001011010110011110001000101000
0100111001010010010100001110100101000101010001000101101001001000101011111000100111010000110011000110
0001000100110000110110100101000010010010010000111000011010100110001000101001001000010111101011110010
0001010010100111000001110100011100111000101010100011001010110010110110000101011011110110001000001000
1101010100101100011001000101010010000100011100101101100010001001000111101001001000010010100111100111
0001010001001000001001011001100001100110100001100000010100100010010010001011100110001010010001001000
0110001111001011110101001001001100110011101110100111001001011100100100110001110001010011001101010010
0011101000001000100001101010010001001001001000011000101011101001000101100110001010010100011100010100
0100001101111101000111001010100111010101010011010010001010000101011101001110101010100101100011100110
0001011000000001010000011000100000000001000111000011010000110001000000100000100010000100001000001110
