32
00000000010000000000100000000000
00100000000000001100010001000011
00000000000000000000001000000000
00000100000000111000000010001001
01000000000000010000000000000000
00000000001001000000000000011000
00100000100000000010000000000000
11001010000100100101100000000001
00000001000000000000000000110100
00000000000001000110001001001100
00100000001010010000000001000000
00000000100000000110000000000010
00000001110000000001000000001000
01100010000000100000000010001110
10000010000000000101101001000000
00100001001000010010100100001000
10000101000100100000010000110000
01000000001000101000001000000001
00000000000001010001010010000000
00010001010000000101000000000000
00001010010000001001011000000000
00000010100100000011000010101000
10011010001100000001001010010000
10001000000100100000001010010000
10010000000000101000100001010010
00000001001000000000000000000000
01001000001000100010001000000010
01100000000000100000001000000000
01001001010000000100011000100000
00010001000001000010000000001000
00110001000000000101000000010010
01100001001000101000000010100000
